"filename", "language", "XML", "C#", "JSON", "Properties", "comment", "blank", "total"
"d:\LanguageLearnig\C#\ChatServer\.idea\.idea.ChatServer\.idea\encodings.xml", "XML", 4, 0, 0, 0, 0, 0, 4
"d:\LanguageLearnig\C#\ChatServer\.idea\.idea.ChatServer\.idea\indexLayout.xml", "XML", 8, 0, 0, 0, 0, 0, 8
"d:\LanguageLearnig\C#\ChatServer\.vs\ChatServer\config\applicationhost.config", "XML", 907, 0, 0, 0, 61, 54, 1022
"d:\LanguageLearnig\C#\ChatServer\.vs\ChatServer\v17\DocumentLayout.json", "JSON", 0, 0, 658, 0, 0, 0, 658
"d:\LanguageLearnig\C#\ChatServer\ChatServer.Common\ChannelExtensions.cs", "C#", 0, 22, 0, 0, 0, 2, 24
"d:\LanguageLearnig\C#\ChatServer\ChatServer.Common\ChatServer.Common.csproj", "XML", 15, 0, 0, 0, 0, 5, 20
"d:\LanguageLearnig\C#\ChatServer\ChatServer.Common\Helper\ProtobufHelper.cs", "C#", 0, 74, 0, 0, 31, 10, 115
"d:\LanguageLearnig\C#\ChatServer\ChatServer.Common\Protobuf\ChatBaseProtocol.cs", "C#", 0, 254, 0, 0, 8, 42, 304
"d:\LanguageLearnig\C#\ChatServer\ChatServer.Common\Protobuf\ChatCommunicateProtocol.cs", "C#", 0, 308, 0, 0, 10, 44, 362
"d:\LanguageLearnig\C#\ChatServer\ChatServer.Common\Protobuf\ChatLoginProtocol.cs", "C#", 0, 559, 0, 0, 25, 79, 663
"d:\LanguageLearnig\C#\ChatServer\ChatServer.Common\Protobuf\ChatRelationProtocol.cs", "C#", 0, 1265, 0, 0, 47, 143, 1455
"d:\LanguageLearnig\C#\ChatServer\ChatServer.Common\Protobuf\ChatUserProtocol.cs", "C#", 0, 1678, 0, 0, 60, 198, 1936
"d:\LanguageLearnig\C#\ChatServer\ChatServer.Common\bin\Debug\net6.0\ChatServer.Common.deps.json", "JSON", 0, 0, 41, 0, 0, 0, 41
"d:\LanguageLearnig\C#\ChatServer\ChatServer.Common\bin\Debug\net6.0\Common.deps.json", "JSON", 0, 0, 41, 0, 0, 0, 41
"d:\LanguageLearnig\C#\ChatServer\ChatServer.Common\bin\Debug\net6.0\Protobuf_Common.deps.json", "JSON", 0, 0, 41, 0, 0, 0, 41
"d:\LanguageLearnig\C#\ChatServer\ChatServer.Common\bin\Debug\net8.0\ChatServer.Common.deps.json", "JSON", 0, 0, 232, 0, 0, 0, 232
"d:\LanguageLearnig\C#\ChatServer\ChatServer.Common\obj\CHCommon.csproj.nuget.dgspec.json", "JSON", 0, 0, 93, 0, 0, 0, 93
"d:\LanguageLearnig\C#\ChatServer\ChatServer.Common\obj\CHCommon.csproj.nuget.g.props", "XML", 16, 0, 0, 0, 0, 0, 16
"d:\LanguageLearnig\C#\ChatServer\ChatServer.Common\obj\CHCommon.csproj.nuget.g.targets", "XML", 2, 0, 0, 0, 0, 0, 2
"d:\LanguageLearnig\C#\ChatServer\ChatServer.Common\obj\ChatServer.Common.csproj.nuget.dgspec.json", "JSON", 0, 0, 87, 0, 0, 0, 87
"d:\LanguageLearnig\C#\ChatServer\ChatServer.Common\obj\ChatServer.Common.csproj.nuget.g.props", "XML", 16, 0, 0, 0, 0, 0, 16
"d:\LanguageLearnig\C#\ChatServer\ChatServer.Common\obj\ChatServer.Common.csproj.nuget.g.targets", "XML", 2, 0, 0, 0, 0, 0, 2
"d:\LanguageLearnig\C#\ChatServer\ChatServer.Common\obj\Common.csproj.nuget.dgspec.json", "JSON", 0, 0, 93, 0, 0, 0, 93
"d:\LanguageLearnig\C#\ChatServer\ChatServer.Common\obj\Common.csproj.nuget.g.props", "XML", 16, 0, 0, 0, 0, 0, 16
"d:\LanguageLearnig\C#\ChatServer\ChatServer.Common\obj\Common.csproj.nuget.g.targets", "XML", 2, 0, 0, 0, 0, 0, 2
"d:\LanguageLearnig\C#\ChatServer\ChatServer.Common\obj\Debug\net6.0\.NETCoreApp,Version=v6.0.AssemblyAttributes.cs", "C#", 0, 3, 0, 0, 1, 1, 5
"d:\LanguageLearnig\C#\ChatServer\ChatServer.Common\obj\Debug\net6.0\CHCommon.AssemblyInfo.cs", "C#", 0, 9, 0, 0, 10, 5, 24
"d:\LanguageLearnig\C#\ChatServer\ChatServer.Common\obj\Debug\net6.0\CHCommon.GeneratedMSBuildEditorConfig.editorconfig", "Properties", 0, 0, 0, 13, 0, 1, 14
"d:\LanguageLearnig\C#\ChatServer\ChatServer.Common\obj\Debug\net6.0\CHCommon.GlobalUsings.g.cs", "C#", 0, 7, 0, 0, 1, 1, 9
"d:\LanguageLearnig\C#\ChatServer\ChatServer.Common\obj\Debug\net6.0\ChatServer.Common.AssemblyInfo.cs", "C#", 0, 9, 0, 0, 10, 5, 24
"d:\LanguageLearnig\C#\ChatServer\ChatServer.Common\obj\Debug\net6.0\ChatServer.Common.GeneratedMSBuildEditorConfig.editorconfig", "Properties", 0, 0, 0, 13, 0, 1, 14
"d:\LanguageLearnig\C#\ChatServer\ChatServer.Common\obj\Debug\net6.0\ChatServer.Common.GlobalUsings.g.cs", "C#", 0, 7, 0, 0, 1, 1, 9
"d:\LanguageLearnig\C#\ChatServer\ChatServer.Common\obj\Debug\net6.0\Common.AssemblyInfo.cs", "C#", 0, 9, 0, 0, 10, 5, 24
"d:\LanguageLearnig\C#\ChatServer\ChatServer.Common\obj\Debug\net6.0\Common.GeneratedMSBuildEditorConfig.editorconfig", "Properties", 0, 0, 0, 13, 0, 1, 14
"d:\LanguageLearnig\C#\ChatServer\ChatServer.Common\obj\Debug\net6.0\Common.GlobalUsings.g.cs", "C#", 0, 7, 0, 0, 1, 1, 9
"d:\LanguageLearnig\C#\ChatServer\ChatServer.Common\obj\Debug\net6.0\Protobuf_Common.AssemblyInfo.cs", "C#", 0, 9, 0, 0, 10, 5, 24
"d:\LanguageLearnig\C#\ChatServer\ChatServer.Common\obj\Debug\net6.0\Protobuf_Common.GeneratedMSBuildEditorConfig.editorconfig", "Properties", 0, 0, 0, 13, 0, 1, 14
"d:\LanguageLearnig\C#\ChatServer\ChatServer.Common\obj\Debug\net6.0\Protobuf_Common.GlobalUsings.g.cs", "C#", 0, 7, 0, 0, 1, 1, 9
"d:\LanguageLearnig\C#\ChatServer\ChatServer.Common\obj\Debug\net8.0\.NETCoreApp,Version=v8.0.AssemblyAttributes.cs", "C#", 0, 3, 0, 0, 1, 1, 5
"d:\LanguageLearnig\C#\ChatServer\ChatServer.Common\obj\Debug\net8.0\ChatServer.Common.AssemblyInfo.cs", "C#", 0, 9, 0, 0, 10, 5, 24
"d:\LanguageLearnig\C#\ChatServer\ChatServer.Common\obj\Debug\net8.0\ChatServer.Common.GeneratedMSBuildEditorConfig.editorconfig", "Properties", 0, 0, 0, 13, 0, 1, 14
"d:\LanguageLearnig\C#\ChatServer\ChatServer.Common\obj\Debug\net8.0\ChatServer.Common.GlobalUsings.g.cs", "C#", 0, 7, 0, 0, 1, 1, 9
"d:\LanguageLearnig\C#\ChatServer\ChatServer.Common\obj\Protobuf_Common.csproj.nuget.dgspec.json", "JSON", 0, 0, 93, 0, 0, 0, 93
"d:\LanguageLearnig\C#\ChatServer\ChatServer.Common\obj\Protobuf_Common.csproj.nuget.g.props", "XML", 16, 0, 0, 0, 0, 0, 16
"d:\LanguageLearnig\C#\ChatServer\ChatServer.Common\obj\Protobuf_Common.csproj.nuget.g.targets", "XML", 2, 0, 0, 0, 0, 0, 2
"d:\LanguageLearnig\C#\ChatServer\ChatServer.Common\obj\project.assets.json", "JSON", 0, 0, 552, 0, 0, 0, 552
"d:\LanguageLearnig\C#\ChatServer\ChatServer.Common\obj\project.packagespec.json", "JSON", 0, 0, 1, 0, 0, 0, 1
"d:\LanguageLearnig\C#\ChatServer\ChatServer.DataBase\ChatServer.DataBase.csproj", "XML", 22, 0, 0, 0, 0, 5, 27
"d:\LanguageLearnig\C#\ChatServer\ChatServer.DataBase\DataBase\ChatServerDbContext.cs", "C#", 0, 16, 0, 0, 9, 6, 31
"d:\LanguageLearnig\C#\ChatServer\ChatServer.DataBase\DataBase\ChatServerDbcontextFactory.cs", "C#", 0, 17, 0, 0, 1, 6, 24
"d:\LanguageLearnig\C#\ChatServer\ChatServer.DataBase\DataBase\DataBaseExtension.cs", "C#", 0, 29, 0, 0, 3, 4, 36
"d:\LanguageLearnig\C#\ChatServer\ChatServer.DataBase\DataBase\DataEntity\ChatPrivate.cs", "C#", 0, 32, 0, 0, 0, 6, 38
"d:\LanguageLearnig\C#\ChatServer\ChatServer.DataBase\DataBase\DataEntity\FriendRelation.cs", "C#", 0, 30, 0, 0, 0, 6, 36
"d:\LanguageLearnig\C#\ChatServer\ChatServer.DataBase\DataBase\DataEntity\FriendRequest.cs", "C#", 0, 33, 0, 0, 0, 9, 42
"d:\LanguageLearnig\C#\ChatServer\ChatServer.DataBase\DataBase\DataEntity\SacurityQuestion.cs", "C#", 0, 28, 0, 0, 0, 6, 34
"d:\LanguageLearnig\C#\ChatServer\ChatServer.DataBase\DataBase\DataEntity\User.cs", "C#", 0, 26, 0, 0, 0, 10, 36
"d:\LanguageLearnig\C#\ChatServer\ChatServer.DataBase\DataBase\DataEntity\UserOnline.cs", "C#", 0, 26, 0, 0, 2, 6, 34
"d:\LanguageLearnig\C#\ChatServer\ChatServer.DataBase\DataBase\DbSettings.cs", "C#", 0, 20, 0, 0, 0, 3, 23
"d:\LanguageLearnig\C#\ChatServer\ChatServer.DataBase\DataBase\Repository\ChatPrivateRepository.cs", "C#", 0, 15, 0, 0, 0, 2, 17
"d:\LanguageLearnig\C#\ChatServer\ChatServer.DataBase\DataBase\Repository\FriendRelationRepository.cs", "C#", 0, 17, 0, 0, 0, 2, 19
"d:\LanguageLearnig\C#\ChatServer\ChatServer.DataBase\DataBase\Repository\FriendRequestRepository.cs", "C#", 0, 17, 0, 0, 0, 2, 19
"d:\LanguageLearnig\C#\ChatServer\ChatServer.DataBase\DataBase\Repository\SacurityQuestionRepository.cs", "C#", 0, 14, 0, 0, 0, 2, 16
"d:\LanguageLearnig\C#\ChatServer\ChatServer.DataBase\DataBase\Repository\UserOnlineRepository.cs", "C#", 0, 10, 0, 0, 0, 2, 12
"d:\LanguageLearnig\C#\ChatServer\ChatServer.DataBase\DataBase\Repository\UserRepository.cs", "C#", 0, 12, 0, 0, 0, 2, 14
"d:\LanguageLearnig\C#\ChatServer\ChatServer.DataBase\DataBase\UnitOfWork\Collections\IEnumerablePagedListExtensions.cs", "C#", 0, 11, 0, 0, 24, 4, 39
"d:\LanguageLearnig\C#\ChatServer\ChatServer.DataBase\DataBase\UnitOfWork\Collections\IPagedList.cs", "C#", 0, 15, 0, 0, 32, 4, 51
"d:\LanguageLearnig\C#\ChatServer\ChatServer.DataBase\DataBase\UnitOfWork\Collections\IQueryablePageListExtensions.cs", "C#", 0, 32, 0, 0, 12, 5, 49
"d:\LanguageLearnig\C#\ChatServer\ChatServer.DataBase\DataBase\UnitOfWork\Collections\PagedList.cs", "C#", 0, 95, 0, 0, 113, 25, 233
"d:\LanguageLearnig\C#\ChatServer\ChatServer.DataBase\DataBase\UnitOfWork\IRepository.cs", "C#", 0, 122, 0, 0, 326, 47, 495
"d:\LanguageLearnig\C#\ChatServer\ChatServer.DataBase\DataBase\UnitOfWork\IRepositoryFactory.cs", "C#", 0, 7, 0, 0, 19, 3, 29
"d:\LanguageLearnig\C#\ChatServer\ChatServer.DataBase\DataBase\UnitOfWork\IUnitOfWork.cs", "C#", 0, 14, 0, 0, 49, 8, 71
"d:\LanguageLearnig\C#\ChatServer\ChatServer.DataBase\DataBase\UnitOfWork\IUnitOfWorkOfT.cs", "C#", 0, 9, 0, 0, 14, 4, 27
"d:\LanguageLearnig\C#\ChatServer\ChatServer.DataBase\DataBase\UnitOfWork\Repository.cs", "C#", 0, 606, 0, 0, 317, 114, 1037
"d:\LanguageLearnig\C#\ChatServer\ChatServer.DataBase\DataBase\UnitOfWork\UnitOfWork.cs", "C#", 0, 119, 0, 0, 66, 27, 212
"d:\LanguageLearnig\C#\ChatServer\ChatServer.DataBase\DataBase\UnitOfWork\UnitOfWorkServiceCollectionExtensions.cs", "C#", 0, 52, 0, 0, 56, 12, 120
"d:\LanguageLearnig\C#\ChatServer\ChatServer.DataBase\DataToProtoProfile.cs", "C#", 0, 33, 0, 0, 0, 7, 40
"d:\LanguageLearnig\C#\ChatServer\ChatServer.DataBase\Migrations\20250131110141_init_1.Designer.cs", "C#", 0, 237, 0, 0, 2, 80, 319
"d:\LanguageLearnig\C#\ChatServer\ChatServer.DataBase\Migrations\20250131110141_init_1.cs", "C#", 0, 227, 0, 0, 3, 23, 253
"d:\LanguageLearnig\C#\ChatServer\ChatServer.DataBase\Migrations\ChatServerDbContextModelSnapshot.cs", "C#", 0, 235, 0, 0, 1, 80, 316
"d:\LanguageLearnig\C#\ChatServer\ChatServer.DataBase\bin\Debug\net6.0\ChatServer.DataBase.deps.json", "JSON", 0, 0, 582, 0, 0, 0, 582
"d:\LanguageLearnig\C#\ChatServer\ChatServer.DataBase\bin\Debug\net8.0\ChatServer.DataBase.deps.json", "JSON", 0, 0, 1118, 0, 0, 0, 1118
"d:\LanguageLearnig\C#\ChatServer\ChatServer.DataBase\bin\Debug\net8.0\ChatServer.DataBase.runtimeconfig.json", "JSON", 0, 0, 13, 0, 0, 0, 13
"d:\LanguageLearnig\C#\ChatServer\ChatServer.DataBase\obj\ChatServer.DataBase.csproj.nuget.dgspec.json", "JSON", 0, 0, 188, 0, 0, 0, 188
"d:\LanguageLearnig\C#\ChatServer\ChatServer.DataBase\obj\ChatServer.DataBase.csproj.nuget.g.props", "XML", 24, 0, 0, 0, 0, 0, 24
"d:\LanguageLearnig\C#\ChatServer\ChatServer.DataBase\obj\ChatServer.DataBase.csproj.nuget.g.targets", "XML", 8, 0, 0, 0, 0, 0, 8
"d:\LanguageLearnig\C#\ChatServer\ChatServer.DataBase\obj\Debug\net6.0\.NETCoreApp,Version=v6.0.AssemblyAttributes.cs", "C#", 0, 3, 0, 0, 1, 1, 5
"d:\LanguageLearnig\C#\ChatServer\ChatServer.DataBase\obj\Debug\net6.0\ChatServer.DataBase.AssemblyInfo.cs", "C#", 0, 9, 0, 0, 10, 5, 24
"d:\LanguageLearnig\C#\ChatServer\ChatServer.DataBase\obj\Debug\net6.0\ChatServer.DataBase.GeneratedMSBuildEditorConfig.editorconfig", "Properties", 0, 0, 0, 13, 0, 1, 14
"d:\LanguageLearnig\C#\ChatServer\ChatServer.DataBase\obj\Debug\net6.0\ChatServer.DataBase.GlobalUsings.g.cs", "C#", 0, 7, 0, 0, 1, 1, 9
"d:\LanguageLearnig\C#\ChatServer\ChatServer.DataBase\obj\Debug\net8.0\.NETCoreApp,Version=v8.0.AssemblyAttributes.cs", "C#", 0, 3, 0, 0, 1, 1, 5
"d:\LanguageLearnig\C#\ChatServer\ChatServer.DataBase\obj\Debug\net8.0\ChatServer.DataBase.AssemblyInfo.cs", "C#", 0, 9, 0, 0, 10, 5, 24
"d:\LanguageLearnig\C#\ChatServer\ChatServer.DataBase\obj\Debug\net8.0\ChatServer.DataBase.GeneratedMSBuildEditorConfig.editorconfig", "Properties", 0, 0, 0, 13, 0, 1, 14
"d:\LanguageLearnig\C#\ChatServer\ChatServer.DataBase\obj\Debug\net8.0\ChatServer.DataBase.GlobalUsings.g.cs", "C#", 0, 7, 0, 0, 1, 1, 9
"d:\LanguageLearnig\C#\ChatServer\ChatServer.DataBase\obj\project.assets.json", "JSON", 0, 0, 2920, 0, 0, 0, 2920
"d:\LanguageLearnig\C#\ChatServer\ChatServer.DataBase\obj\project.packagespec.json", "JSON", 0, 0, 1, 0, 0, 0, 1
"d:\LanguageLearnig\C#\ChatServer\ChatServer.Main\App.cs", "C#", 0, 72, 0, 0, 5, 15, 92
"d:\LanguageLearnig\C#\ChatServer\ChatServer.Main\ChatServer.Main.csproj", "XML", 29, 0, 0, 0, 0, 6, 35
"d:\LanguageLearnig\C#\ChatServer\ChatServer.Main\IOServer\Manager\ClientChannelManager.cs", "C#", 0, 103, 0, 0, 22, 20, 145
"d:\LanguageLearnig\C#\ChatServer\ChatServer.Main\IOServer\ServerHandler\ClientConnectHandler.cs", "C#", 0, 82, 0, 0, 7, 16, 105
"d:\LanguageLearnig\C#\ChatServer\ChatServer.Main\IOServer\ServerHandler\EchoServerHandler.cs", "C#", 0, 31, 0, 0, 9, 7, 47
"d:\LanguageLearnig\C#\ChatServer\ChatServer.Main\MessageOperate\BusinessServer.cs", "C#", 0, 135, 0, 0, 47, 27, 209
"d:\LanguageLearnig\C#\ChatServer\ChatServer.Main\MessageOperate\IProcessor.cs", "C#", 0, 14, 0, 0, 0, 2, 16
"d:\LanguageLearnig\C#\ChatServer\ChatServer.Main\MessageOperate\Processor\FriendRequestProcessor.cs", "C#", 0, 85, 0, 0, 17, 17, 119
"d:\LanguageLearnig\C#\ChatServer\ChatServer.Main\MessageOperate\Processor\FriendResponseProcessor.cs", "C#", 0, 141, 0, 0, 25, 22, 188
"d:\LanguageLearnig\C#\ChatServer\ChatServer.Main\MessageOperate\Processor\GetUserRequestProcessor.cs", "C#", 0, 45, 0, 0, 8, 6, 59
"d:\LanguageLearnig\C#\ChatServer\ChatServer.Main\MessageOperate\Processor\LoginRequestProcessor.cs", "C#", 0, 39, 0, 0, 8, 8, 55
"d:\LanguageLearnig\C#\ChatServer\ChatServer.Main\MessageOperate\Processor\LogoutRequestProcessor.cs", "C#", 0, 24, 0, 0, 7, 6, 37
"d:\LanguageLearnig\C#\ChatServer\ChatServer.Main\MessageOperate\Processor\OutlineMessageRequestProcessor.cs", "C#", 0, 78, 0, 0, 12, 17, 107
"d:\LanguageLearnig\C#\ChatServer\ChatServer.Main\MessageOperate\Processor\RegisteRequestProcessor.cs", "C#", 0, 34, 0, 0, 10, 8, 52
"d:\LanguageLearnig\C#\ChatServer\ChatServer.Main\MessageOperate\Processor\UpdateUserDataProcessor.cs", "C#", 0, 34, 0, 0, 7, 5, 46
"d:\LanguageLearnig\C#\ChatServer\ChatServer.Main\MessageOperate\ProtobufDispatcher.cs", "C#", 0, 76, 0, 0, 16, 15, 107
"d:\LanguageLearnig\C#\ChatServer\ChatServer.Main\MessageOperate\Server\CommunicateServer.cs", "C#", 0, 24, 0, 0, 1, 3, 28
"d:\LanguageLearnig\C#\ChatServer\ChatServer.Main\MessageOperate\Server\EntityServer.cs", "C#", 0, 21, 0, 0, 0, 3, 24
"d:\LanguageLearnig\C#\ChatServer\ChatServer.Main\MessageOperate\Server\LoginServer.cs", "C#", 0, 23, 0, 0, 0, 3, 26
"d:\LanguageLearnig\C#\ChatServer\ChatServer.Main\MessageOperate\ServiceRegisteExtenstion.cs", "C#", 0, 39, 0, 0, 16, 7, 62
"d:\LanguageLearnig\C#\ChatServer\ChatServer.Main\Program.cs", "C#", 0, 14, 0, 0, 0, 0, 14
"d:\LanguageLearnig\C#\ChatServer\ChatServer.Main\ServerEntity\ClientChannel.cs", "C#", 0, 29, 0, 0, 0, 7, 36
"d:\LanguageLearnig\C#\ChatServer\ChatServer.Main\ServerEntity\MessageUnit.cs", "C#", 0, 29, 0, 0, 0, 5, 34
"d:\LanguageLearnig\C#\ChatServer\ChatServer.Main\ServerEntity\MessagesContainer.cs", "C#", 0, 27, 0, 0, 0, 6, 33
"d:\LanguageLearnig\C#\ChatServer\ChatServer.Main\Services\FriendService.cs", "C#", 0, 33, 0, 0, 1, 5, 39
"d:\LanguageLearnig\C#\ChatServer\ChatServer.Main\Services\Helper\CipherHelper.cs", "C#", 0, 64, 0, 0, 10, 8, 82
"d:\LanguageLearnig\C#\ChatServer\ChatServer.Main\Services\LoginService.cs", "C#", 0, 74, 0, 0, 11, 17, 102
"d:\LanguageLearnig\C#\ChatServer\ChatServer.Main\Services\UserService.cs", "C#", 0, 44, 0, 0, 3, 10, 57
"d:\LanguageLearnig\C#\ChatServer\ChatServer.Main\appsettings.json", "JSON", 0, 0, 39, 0, 0, 0, 39
"d:\LanguageLearnig\C#\ChatServer\ChatServer.Main\bin\Debug\net8.0\ChatServer.Main.deps.json", "JSON", 0, 0, 1279, 0, 0, 0, 1279
"d:\LanguageLearnig\C#\ChatServer\ChatServer.Main\bin\Debug\net8.0\ChatServer.Main.runtimeconfig.json", "JSON", 0, 0, 13, 0, 0, 0, 13
"d:\LanguageLearnig\C#\ChatServer\ChatServer.Main\bin\Debug\net8.0\appsettings.json", "JSON", 0, 0, 39, 0, 0, 0, 39
"d:\LanguageLearnig\C#\ChatServer\ChatServer.Main\obj\ChatServer.Console.csproj.nuget.dgspec.json", "JSON", 0, 0, 444, 0, 0, 0, 444
"d:\LanguageLearnig\C#\ChatServer\ChatServer.Main\obj\ChatServer.Console.csproj.nuget.g.props", "XML", 23, 0, 0, 0, 0, 0, 23
"d:\LanguageLearnig\C#\ChatServer\ChatServer.Main\obj\ChatServer.Console.csproj.nuget.g.targets", "XML", 21, 0, 0, 0, 0, 0, 21
"d:\LanguageLearnig\C#\ChatServer\ChatServer.Main\obj\ChatServer.Main.csproj.nuget.dgspec.json", "JSON", 0, 0, 398, 0, 0, 0, 398
"d:\LanguageLearnig\C#\ChatServer\ChatServer.Main\obj\ChatServer.Main.csproj.nuget.g.props", "XML", 23, 0, 0, 0, 0, 0, 23
"d:\LanguageLearnig\C#\ChatServer\ChatServer.Main\obj\ChatServer.Main.csproj.nuget.g.targets", "XML", 9, 0, 0, 0, 0, 0, 9
"d:\LanguageLearnig\C#\ChatServer\ChatServer.Main\obj\ChatServer.csproj.nuget.dgspec.json", "JSON", 0, 0, 444, 0, 0, 0, 444
"d:\LanguageLearnig\C#\ChatServer\ChatServer.Main\obj\ChatServer.csproj.nuget.g.props", "XML", 23, 0, 0, 0, 0, 0, 23
"d:\LanguageLearnig\C#\ChatServer\ChatServer.Main\obj\ChatServer.csproj.nuget.g.targets", "XML", 21, 0, 0, 0, 0, 0, 21
"d:\LanguageLearnig\C#\ChatServer\ChatServer.Main\obj\Debug\net6.0\.NETCoreApp,Version=v6.0.AssemblyAttributes.cs", "C#", 0, 3, 0, 0, 1, 1, 5
"d:\LanguageLearnig\C#\ChatServer\ChatServer.Main\obj\Debug\net6.0\ChatServer.AssemblyInfo.cs", "C#", 0, 9, 0, 0, 10, 5, 24
"d:\LanguageLearnig\C#\ChatServer\ChatServer.Main\obj\Debug\net6.0\ChatServer.Console.AssemblyInfo.cs", "C#", 0, 9, 0, 0, 10, 5, 24
"d:\LanguageLearnig\C#\ChatServer\ChatServer.Main\obj\Debug\net6.0\ChatServer.Console.GeneratedMSBuildEditorConfig.editorconfig", "Properties", 0, 0, 0, 13, 0, 1, 14
"d:\LanguageLearnig\C#\ChatServer\ChatServer.Main\obj\Debug\net6.0\ChatServer.Console.GlobalUsings.g.cs", "C#", 0, 7, 0, 0, 1, 1, 9
"d:\LanguageLearnig\C#\ChatServer\ChatServer.Main\obj\Debug\net6.0\ChatServer.GeneratedMSBuildEditorConfig.editorconfig", "Properties", 0, 0, 0, 13, 0, 1, 14
"d:\LanguageLearnig\C#\ChatServer\ChatServer.Main\obj\Debug\net6.0\ChatServer.GlobalUsings.g.cs", "C#", 0, 7, 0, 0, 1, 1, 9
"d:\LanguageLearnig\C#\ChatServer\ChatServer.Main\obj\Debug\net6.0\ChatServer.Main.AssemblyInfo.cs", "C#", 0, 9, 0, 0, 10, 5, 24
"d:\LanguageLearnig\C#\ChatServer\ChatServer.Main\obj\Debug\net6.0\ChatServer.Main.GeneratedMSBuildEditorConfig.editorconfig", "Properties", 0, 0, 0, 13, 0, 1, 14
"d:\LanguageLearnig\C#\ChatServer\ChatServer.Main\obj\Debug\net6.0\ChatServer.Main.GlobalUsings.g.cs", "C#", 0, 7, 0, 0, 1, 1, 9
"d:\LanguageLearnig\C#\ChatServer\ChatServer.Main\obj\Debug\net8.0\.NETCoreApp,Version=v8.0.AssemblyAttributes.cs", "C#", 0, 3, 0, 0, 1, 1, 5
"d:\LanguageLearnig\C#\ChatServer\ChatServer.Main\obj\Debug\net8.0\ChatServer.Main.AssemblyInfo.cs", "C#", 0, 9, 0, 0, 10, 5, 24
"d:\LanguageLearnig\C#\ChatServer\ChatServer.Main\obj\Debug\net8.0\ChatServer.Main.GeneratedMSBuildEditorConfig.editorconfig", "Properties", 0, 0, 0, 13, 0, 1, 14
"d:\LanguageLearnig\C#\ChatServer\ChatServer.Main\obj\Debug\net8.0\ChatServer.Main.GlobalUsings.g.cs", "C#", 0, 7, 0, 0, 1, 1, 9
"d:\LanguageLearnig\C#\ChatServer\ChatServer.Main\obj\project.assets.json", "JSON", 0, 0, 3222, 0, 0, 0, 3222
"d:\LanguageLearnig\C#\ChatServer\ChatServer.Main\obj\project.packagespec.json", "JSON", 0, 0, 1, 0, 0, 0, 1
"d:\LanguageLearnig\C#\ChatServer\ChatServer.Test\ChatServer.Test.csproj", "XML", 12, 0, 0, 0, 0, 4, 16
"d:\LanguageLearnig\C#\ChatServer\ChatServer.Test\EchoClientHandler.cs", "C#", 0, 29, 0, 0, 0, 7, 36
"d:\LanguageLearnig\C#\ChatServer\ChatServer.Test\Program.cs", "C#", 0, 49, 0, 0, 0, 10, 59
"d:\LanguageLearnig\C#\ChatServer\ChatServer.Test\bin\Debug\net8.0\ChatServer.Test.deps.json", "JSON", 0, 0, 614, 0, 0, 0, 614
"d:\LanguageLearnig\C#\ChatServer\ChatServer.Test\bin\Debug\net8.0\ChatServer.Test.runtimeconfig.json", "JSON", 0, 0, 12, 0, 0, 0, 12
"d:\LanguageLearnig\C#\ChatServer\ChatServer.Test\obj\ChatServer.Test.csproj.nuget.dgspec.json", "JSON", 0, 0, 266, 0, 0, 0, 266
"d:\LanguageLearnig\C#\ChatServer\ChatServer.Test\obj\ChatServer.Test.csproj.nuget.g.props", "XML", 16, 0, 0, 0, 0, 0, 16
"d:\LanguageLearnig\C#\ChatServer\ChatServer.Test\obj\ChatServer.Test.csproj.nuget.g.targets", "XML", 7, 0, 0, 0, 0, 0, 7
"d:\LanguageLearnig\C#\ChatServer\ChatServer.Test\obj\Debug\net8.0\.NETCoreApp,Version=v8.0.AssemblyAttributes.cs", "C#", 0, 3, 0, 0, 1, 1, 5
"d:\LanguageLearnig\C#\ChatServer\ChatServer.Test\obj\Debug\net8.0\ChatServer.Test.AssemblyInfo.cs", "C#", 0, 9, 0, 0, 10, 5, 24
"d:\LanguageLearnig\C#\ChatServer\ChatServer.Test\obj\Debug\net8.0\ChatServer.Test.GeneratedMSBuildEditorConfig.editorconfig", "Properties", 0, 0, 0, 13, 0, 1, 14
"d:\LanguageLearnig\C#\ChatServer\ChatServer.Test\obj\Debug\net8.0\ChatServer.Test.GlobalUsings.g.cs", "C#", 0, 7, 0, 0, 1, 1, 9
"d:\LanguageLearnig\C#\ChatServer\ChatServer.Test\obj\project.assets.json", "JSON", 0, 0, 1510, 0, 0, 0, 1510
"d:\LanguageLearnig\C#\ChatServer\ChatServer.Test\obj\project.packagespec.json", "JSON", 0, 0, 1, 0, 0, 0, 1
"d:\LanguageLearnig\C#\ChatServer\SocketServer\Application.cs", "C#", 0, 56, 0, 0, 34, 17, 107
"d:\LanguageLearnig\C#\ChatServer\SocketServer\Server\ISocketServer.cs", "C#", 0, 15, 0, 0, 0, 2, 17
"d:\LanguageLearnig\C#\ChatServer\SocketServer\Server\SocketServer.cs", "C#", 0, 80, 0, 0, 8, 16, 104
"d:\LanguageLearnig\C#\ChatServer\SocketServer\Server\SocketServerBuilder.cs", "C#", 0, 19, 0, 0, 0, 4, 23
"d:\LanguageLearnig\C#\ChatServer\SocketServer\SocketServer.csproj", "XML", 19, 0, 0, 0, 0, 4, 23
"d:\LanguageLearnig\C#\ChatServer\SocketServer\bin\Debug\net6.0\SocketServer.deps.json", "JSON", 0, 0, 604, 0, 0, 0, 604
"d:\LanguageLearnig\C#\ChatServer\SocketServer\bin\Debug\net8.0\SocketServer.deps.json", "JSON", 0, 0, 552, 0, 0, 0, 552
"d:\LanguageLearnig\C#\ChatServer\SocketServer\obj\Debug\net6.0\.NETCoreApp,Version=v6.0.AssemblyAttributes.cs", "C#", 0, 3, 0, 0, 1, 1, 5
"d:\LanguageLearnig\C#\ChatServer\SocketServer\obj\Debug\net6.0\SocketServer.AssemblyInfo.cs", "C#", 0, 9, 0, 0, 10, 5, 24
"d:\LanguageLearnig\C#\ChatServer\SocketServer\obj\Debug\net6.0\SocketServer.GeneratedMSBuildEditorConfig.editorconfig", "Properties", 0, 0, 0, 13, 0, 1, 14
"d:\LanguageLearnig\C#\ChatServer\SocketServer\obj\Debug\net6.0\SocketServer.GlobalUsings.g.cs", "C#", 0, 7, 0, 0, 1, 1, 9
"d:\LanguageLearnig\C#\ChatServer\SocketServer\obj\Debug\net8.0\.NETCoreApp,Version=v8.0.AssemblyAttributes.cs", "C#", 0, 3, 0, 0, 1, 1, 5
"d:\LanguageLearnig\C#\ChatServer\SocketServer\obj\Debug\net8.0\SocketServer.AssemblyInfo.cs", "C#", 0, 9, 0, 0, 10, 5, 24
"d:\LanguageLearnig\C#\ChatServer\SocketServer\obj\Debug\net8.0\SocketServer.GeneratedMSBuildEditorConfig.editorconfig", "Properties", 0, 0, 0, 13, 0, 1, 14
"d:\LanguageLearnig\C#\ChatServer\SocketServer\obj\Debug\net8.0\SocketServer.GlobalUsings.g.cs", "C#", 0, 7, 0, 0, 1, 1, 9
"d:\LanguageLearnig\C#\ChatServer\SocketServer\obj\SocketServer.csproj.nuget.dgspec.json", "JSON", 0, 0, 115, 0, 0, 0, 115
"d:\LanguageLearnig\C#\ChatServer\SocketServer\obj\SocketServer.csproj.nuget.g.props", "XML", 16, 0, 0, 0, 0, 0, 16
"d:\LanguageLearnig\C#\ChatServer\SocketServer\obj\SocketServer.csproj.nuget.g.targets", "XML", 7, 0, 0, 0, 0, 0, 7
"d:\LanguageLearnig\C#\ChatServer\SocketServer\obj\project.assets.json", "JSON", 0, 0, 1440, 0, 0, 0, 1440
"d:\LanguageLearnig\C#\ChatServer\SocketServer\obj\project.packagespec.json", "JSON", 0, 0, 1, 0, 0, 0, 1
"Total", "-", 1286, 8229, 17748, 182, 1738, 1541, 30724